1111111111111111111111111111111111
10000000000000C00000C0000000000001
1010010100100000101001000000010101
1010010010101010001001000000010101
1P0000000C00C00M0000000000000000C1
1111111111111111111111111111011111
1111111111111111111111111111011111
100000000000000C00000C000000000001
1010010100100M00101001000000010101
1010010010101010001001000000010101
100000000C00C00000M0000000000000C1
1000000000M000C00000C000M000000001
1010010100100000101001000000010101
1010010010101010001001000000010101
1E0000000C00C00000000M0000000000C1
1111111111111111111111111111111111