111111111111111111111111111111111111
1P1000000000000000000000000000000001
10100010000100000CC000111111100001C1
10100010000100000CC000000000100001C1
101000111111110M0CC000011111100M01C1
10000000000100000CC00010M000000001C1
10000000011111000CC000111111100001C1
1000000000000000000000000000000001E1
111111111111111111111111111111111111