1111111111111111
1P00C00000000C01
1C11C111C111C111
1C1E000000000M01
1C100C111111C001
1C00000MCM000C01
1111111111111111