1111111111111111
1P0100000000C011
1C11C111C111C1C1
1C1E000000000M01
1C100C111111C001
1C00000MCM000C01
1111111111111111