1111111111111
1001000M000C1
10M0011111001
1P0011E00M001
1111111111111